8 24
|----------------------|
|@....|......F...P.....|
|..-..|.---......---...|
|.....|..F.............|
|.P------....|.--......|
|.....|......|....F....|
|.--.........F.....P...|
|----------------------|